$..#.....#......
##.#..##.######.
*#.##..#......#.
.#.#.@##.#.##.#.
.#.......#.#$.#.
.#########.####.
......#.........
.######.#..####
........#.###$#
#########.#.#.#
..*.....#...#.#$
......#####.#.##
.####..##...#...
.#..#...#..##.#.
.#..#.....###.#.
....###..##$#.#.
.####.#.....#...
......#######.##
*.###..........e