.....#
..##.#.#.##
.##..*....#
##.@...#..#
#......#*.#
#.#...##..#
..#..#....#
.##..#.#.##
.#*.#.*.##
.#..#...#
e###..##