##......######..*..
$#...**......###...
.#.#.#####.#######.
.#.##@...###.....#.
...#...#.....###.#.
####.#########.#.#.
......#.**.......#.
.#########.#######.
.........#.........
#####.##.####.#####
..#$#..#.#........#
..#.##.#.####.##.##
..#....#..#.#.#..$#
..#######.#...#.###
....#.....#####.#..
###...#.###........
$.#####.#.#.#######
........#.........
#############e####
