.....#
..####.#.##
..#...##..#
.#.@.#..*.#
#..*......#
###.#.##..#
*.#.......#
.##..#.#.##
.#*.#..#.#
....#..###
.###..##