.....#
..##.#.#.##
.##..*....#
##.@...#..#
#......#*.#
###...##..#
..#..#....#
.##..#.#.##
.#*.#.*.##
.#..#..##
.###..##