...e.#
..##...#.##
..#.####..#
.#.@.#..*.#
#..*......#
###.#.##..#
*.#.......#
.##..#.#.##
.#*.#..#.#
....#..###
.###..##