...###
..##.#.####
.##..###..#
##.@...*..#
#......#..#
###..#.#..#
.$#*.#....#
.##.##.#.##
.#..*.....#
.......##
.#######e