$.#..$##...###
#.##.#..#.#$..
..#..#.#..###.
.#...@...#...#.
.#.#..#.##.#.#.
.#.#.##.#..#.#.
.#.#..*..#.#.#.
.#..#.##.#.#.#.
..#..#...#.#...
#.##.#.##..#.##
#....#....*#..e